<Row>10</Row>
<Column>10</Column>
<Maze>
E	1	1	1	0	0	0	0	0	0
0	0	0	1	0	0	0	1	0	0
0	1	0	1	1	0	0	1	0	0
0	1	0	0	1	0	1	1	0	0
0	1	0	0	1	0	1	1	0	0
1	1	1	0	1	0	1	0	0	0
0	0	1	0	0	0	1	0	1	1
0	0	1	0	0	0	1	0	1	1
0	1	1	0	1	0	1	0	0	0
0	0	0	0	1	0	1	1	0	Q
</Maze>